########################################
#           ##   ##  # # ###     # ##   
# ##           #  ### #### ##     #### #
#   #   #       # ### ####  #     ##    
# # ##   ##   # #      ####           ##
#         #   ######   ###              
# #   #     # ### ##   ###  ## #        
#    ###   ####### #   ###  ##   ##    #
#    ####  #### ######     #####    ##  
#     # #   ##   ## ##     ###    # ####
  ##  # #    #######  ##  ## #  ##  ####
##      #     ######  #  ###            
## #  # ##     # #   #  ####   ###### ##
##                 #   # ###    # ###   
#### ##  #    #   ####  #  ##   #  #### 
# ###### # #  ###  # #   #  ##   #### ##
#  ##  #    #    # ##    #####    ######
## ###     ####   ### ##   ###  #  ##  #
## ####     #### ######           # ## #
########################################
