5 6 4 6 4 6 5 4 4 6 6 6 4 4 5 6 6 6 6 6 
5 1 0 1 4 1 1 1 2 1 6 4 2 1 2 6 6 4 1 4 
4 6 2 6 1 1 4 5 0 0 1 2 1 2 2 0 5 5 6 6 
5 4 2 1 1 5 1 4 0 1 1 0 6 2 1 2 0 5 4 6 
6 0 1 5 1 0 1 2 1 1 2 1 1 1 0 4 0 1 6 4 
1 0 1 5 0 4 1 0 0 2 0 1 1 2 2 6 5 0 2 4 
5 6 0 4 0 2 0 0 1 5 4 2 1 1 0 6 6 5 2 7 
6 0 0 1 0 0 2 1 5 5 6 6 0 2 2 6 6 5 2 6 
5 0 2 0 4 4 1 1 1 1 6 4 2 1 0 6 2 4 4 5 
6 5 4 6 4 4 5 6 5 5 4 4 4 6 6 5 5 4 6 6 
