4 6 6 4 6 5 5 6 5 6 5 4 5 4 4 5 4 4 4 6 4 4 5 4 5 6 5 4 5 5 6 5 6 6 4 6 6 4 6 4 
4 2 5 2 4 5 1 2 1 0 4 4 4 5 4 4 1 1 2 6 0 1 2 0 5 6 6 0 0 0 2 1 1 1 1 2 1 5 2 4 
4 1 4 0 2 6 4 4 5 4 1 1 5 2 2 0 5 4 1 1 0 0 0 2 0 2 1 0 6 1 1 1 0 0 2 2 2 0 5 5 
4 4 4 1 1 2 1 2 4 6 5 4 5 6 2 5 2 2 1 6 0 6 2 2 0 2 0 1 5 2 6 6 0 1 0 1 2 2 2 4 
5 5 4 2 0 1 5 6 6 4 1 0 2 0 4 1 0 0 0 2 5 2 0 0 6 0 4 1 2 2 4 5 6 1 0 2 1 2 2 5 
5 6 2 0 1 1 4 4 6 4 4 5 0 2 6 0 6 4 0 0 5 2 5 1 0 1 5 5 2 5 5 6 4 5 1 1 0 1 1 7 
6 4 1 0 2 0 1 4 5 4 4 5 2 2 6 1 6 5 4 2 0 2 5 4 0 2 6 6 6 5 1 2 0 5 4 4 1 1 0 5 
4 0 2 0 5 2 2 0 1 6 1 4 4 2 5 5 1 5 1 0 2 6 2 0 0 2 5 4 4 4 5 5 2 6 1 4 4 6 5 5 
5 2 2 1 2 2 4 5 5 4 0 5 6 1 1 4 2 0 6 1 0 0 0 1 6 1 1 4 4 5 6 4 4 4 6 0 0 5 5 4 
6 5 4 0 2 1 0 1 2 1 4 4 5 4 2 5 1 2 2 1 0 6 6 0 5 1 0 5 4 5 6 4 5 4 6 1 0 1 2 4 
2 2 6 2 1 2 5 2 1 0 2 1 2 4 2 6 4 6 2 0 1 1 0 6 4 4 0 5 6 5 5 5 5 6 6 6 4 2 0 5 
5 2 1 4 0 0 4 4 1 1 0 1 1 4 4 2 0 2 1 4 4 6 5 6 5 4 2 1 2 5 4 5 4 4 6 2 4 5 4 5 
5 2 2 4 1 0 5 2 5 1 1 4 1 5 5 2 2 4 4 2 4 1 4 5 4 5 4 1 2 6 0 0 6 6 6 5 6 2 4 6 
6 0 1 0 0 2 5 0 4 2 4 2 5 5 2 0 6 5 2 2 2 1 6 5 4 1 0 4 5 5 2 2 6 6 6 1 5 4 5 6 
4 0 1 5 2 5 4 2 6 1 1 0 4 2 1 6 0 6 5 0 5 2 5 4 4 1 0 4 5 6 6 1 2 1 4 1 2 4 5 4 
4 0 1 2 6 4 6 0 5 4 0 0 2 0 0 2 2 6 4 2 2 2 4 4 1 1 0 1 4 5 5 2 2 1 6 1 1 4 5 5 
5 1 5 6 4 5 5 5 5 2 0 1 2 2 5 2 0 6 6 5 6 2 4 6 0 2 5 4 6 2 6 0 2 1 6 0 0 5 5 4 
4 0 2 4 0 5 6 5 1 4 2 1 1 0 6 5 5 1 5 5 4 0 5 1 1 0 0 2 5 5 2 2 1 5 4 6 4 6 6 6 
4 4 5 1 0 1 4 4 4 6 5 0 2 1 2 0 5 2 0 0 6 4 5 4 5 0 6 4 6 6 0 4 4 6 4 4 2 4 5 4 
6 4 5 6 4 5 5 6 4 5 5 4 4 6 5 6 6 5 6 4 4 4 6 5 4 5 4 5 4 4 5 5 4 6 5 6 5 6 4 6 
