8 7 5 4 4 8 5 6 8 5 7 4 4 8 6 8 7 4 7 4 
6 6 2 2 4 5 8 7 6 1 1 0 2 6 7 1 0 1 8 4 
5 0 0 2 2 1 2 8 1 1 1 6 1 0 6 8 1 1 8 8 
5 7 5 5 2 0 5 4 0 2 1 0 5 1 0 4 8 1 1 9 
7 5 6 4 7 0 8 1 1 6 6 0 6 6 2 0 4 0 1 8 
1 1 8 4 8 8 2 2 0 5 8 1 8 5 8 0 1 2 5 8 
6 2 1 7 6 1 0 4 2 6 8 1 2 2 7 8 0 6 6 4 
6 8 2 1 7 0 0 8 1 5 4 6 7 1 4 4 1 6 2 8 
5 7 6 2 1 2 2 7 6 5 1 6 1 5 4 8 6 8 6 5 
7 7 6 8 7 7 5 4 7 8 5 6 7 7 8 4 7 6 4 6 
