5 6 4 7 5 7 8 6 6 4 4 6 4 7 6 7 8 8 5 5 
5 5 4 2 6 8 2 0 8 5 2 5 4 5 8 0 2 0 2 7 
4 4 6 1 5 6 0 0 2 0 1 1 2 2 0 2 5 2 0 5 
8 1 7 2 1 6 2 0 0 2 8 6 0 2 2 7 1 8 0 4 
4 2 7 8 2 1 5 7 0 1 1 5 0 1 2 5 0 4 1 9 
1 0 4 7 6 2 2 2 0 1 0 1 2 0 0 8 6 1 4 5 
4 0 2 8 5 2 1 0 1 2 1 2 7 6 5 5 7 1 0 4 
6 1 0 6 2 1 8 1 1 2 0 0 2 8 7 7 8 5 7 6 
8 4 1 2 0 7 7 4 2 1 1 6 2 0 8 5 5 6 4 6 
4 5 8 4 7 4 7 7 6 6 4 6 4 8 7 7 7 5 8 7 
